{
  "sx": 1024,
  "sz": 1024,
  "buildings": [
    {
      "x": 289,
      "z": 164,
      "sx": 50,
      "sy": 40,
      "sz": 84
    },
    {
      "x": 409,
      "z": 160,
      "sx": 40,
      "sy": 20,
      "sz": 68
    },
    {
      "x": 554,
      "z": 153,
      "sx": 130,
      "sy": 30,
      "sz": 86
    },
    {
      "x": 542,
      "z": 441,
      "sx": 57,
      "sy": 50,
      "sz": 62
    },
    {
      "x": 182,
      "z": 564,
      "sx": 52,
      "sy": 30,
      "sz": 74
    },
    {
      "x": 543,
      "z": 600,
      "sx": 101,
      "sy": 40,
      "sz": 103
    },
    {
      "x": 730,
      "z": 552,
      "sx": 63,
      "sy": 20,
      "sz": 120
    },
    {
      "x": 856,
      "z": 583,
      "sx": 113,
      "sy": 20,
      "sz": 56
    },
    {
      "x": 604,
      "z": 730,
      "sx": 44,
      "sy": 15,
      "sz": 44
    },
    {
      "x": 228,
      "z": 865,
      "sx": 110,
      "sy": 40,
      "sz": 62
    },
    {
      "x": 785,
      "z": 916,
      "sx": 127,
      "sy": 30,
      "sz": 108
    }
  ]
}
